map = [
'11111111111111111100'
'11000000001111111001'
'11011111101111111011'
'11001111101111111011'
'11101111101111111011'
'11101111100000011011'
'11101111111111011011'
'10001111111111000011'
'10111111111111111111'
'00111111111111111111'
];
